26 18
WWWWWWWWWWWWWWWWWWWWWWWWWW
W000000d0000W000000000000W
W00000000000W000000000000W
W00WWWWWWWWDW000000000000W
W00W0000GW00W000000000000W
W00WWW0W0W00W000000000000W
WS0W0WAW0W00W000000000000W
W0000W0WWW00W000000000000W
Wb000000aW00W000000000000W
W00000000W00W000000000000W
W00WBWWW0W00C000000000000W
W00W0WWW0W00W000000000000W
W00W00W00Wc0W000000000000W
W00W00000W00W000000000000W
W00WWWWWWWWEW000000000000W
W00000000000W000000000000W
W0000000e000W000000000000W
WWWWWWWWWWWWWWWWWWWWWWWWWW
